BBBBBBBBBB
BFFFFFFFFB
BFFFFFFFFB
BFFFBBFFFB
BFFFBBFFFB
BFFFFFFFFB
BFFFFFFFFB
BBBBBBBBBB
